10 21  99
#####################
#                   #
#------ -------    %#
#      H*      ###H##
#  H------        H #
#  H *  H% -----% H*#
## H####H##     ##H##
#  H                #
#@ H              % #
#####################