5 5 -1
#  ##
# -*#
#@ %#
# H #
#####
