15 25  99
#########################
@  -----       %   + ----
###     #####H#######    
   -----     H        H##
####H  ######H########H##
    H        H        H  
    H        H        H  
----H--------H        H  
    H    *   H        H  
-------------------------
                       + 
#######     ######    ###
                         
* * %             +      
#########################