16 16 -1
################
#              #
#%           @*#
###H########H###
#  H        H  #
#  H        H  #
#  H--------H  #
#  H        H  #
#  H        H  #
#  H        H H#
#  H        H H#
#* H %--------H#
######        H#
#             H#
#*         % *H#
################