18 25 -1
*                        
###H###################H#
   H                   H 
   H                   H 
   H                   H 
 % H      ---------    H%
 #########         H#####
                   H     
H#########         H     
H          ------  H     
H            *     H     
H                  H     
H##############    H     
H                  H     
H  *   ---------   H    *
H######         #########
H                        
H    %                % *