5 8 7
########
#      #
#    @*#
###H##H#
########
